#######
#     #
#  I  #
#     #
####0##