############
  I        #
#######    #
#          #
#     #   0#
############